20 11
####################
#..................#
#.################.#
#.#...#.#........#.#
#.#...#..........#.#
#.#.....#........#.#
#.#####.#.######.#.#
#.......#...#....#.#
#.#########.######.#
#..................#
####################