15 9
###############
#.............#
#.#######.....#
#...#...#...#.#
#...#####...#.#
#...........#.#
#....######.#.#
#..#...#......#
###############
